##########
#--------#
#--------#
#--------#
#--------#
#--------#
#--------#
#--------#
#-------G#
##########
=====
player; Player; Down, (1, 1)
=====
guard; Guard1:
P0/(8, 8)/Left;
P1/(5, 5)/None
